gary.schiff@minneapolis.mn.us
opa@minneapolis.mn.us
sasvenssen@minneapolis.mn.us
Shannon.McDonough@ci.minneapolis.mn.us	minneapolis
marshall.collier@ci.minneapolis.mn.us	marshall0
martha.holtondimick@ci.minneapolis.mn.us	winter2011
james.dykes@ci.minneapolis.mn.us	nicollet
james.huntzicker@ci.minneapolis.mn.us	badge9142
james.moore@ci.minneapolis.mn.us	casslake
james.patterson@ci.minneapolis.mn.us	SipRnp
james.spencer@ci.minneapolis.mn.us	5f
james.wilson@ci.minneapolis.mn.us	wilsoje0
jamesma0@ci.minneapolis.mn.us	ladder5
susan.guerrero@ci.minneapolis.mn.us	drb*1965
susan.jones@ci.minneapolis.mn.us	dh181818
kimberly.lund@ci.minneapolis.mn.us	sarah10
chad.komarec@ci.minneapolis.mn.us	Larissa
charles.curtis@ci.minneapolis.mn.us	549482088237185
charles.green@ci.minneapolis.mn.us	Dominic
charlie.adams@ci.minneapolis.mn.us	driver
kent.robbins@ci.minneapolis.mn.us	manystories
kerry.sovell@ci.minneapolis.mn.us	halloween
kerstin.hammarberg@ci.minneapolis.mn.us	camiller
kesha.campagna@ci.minneapolis.mn.us	cantsee
kevin.carroll@ci.minneapolis.mn.us	llorracpk
terri.spencer@ci.minneapolis.mn.us	dolores
teryl.rosas@ci.minneapolis.mn.us	732108370040178
chris.backes@ci.minneapolis.mn.us	cb5082026
janine.ryan@ci.minneapolis.mn.us	a7898347
janis.lajon@ci.minneapolis.mn.us	82388goose
jason.reimer@ci.minneapolis.mn.us	88jake
jason.roberts@ci.minneapolis.mn.us	j032675
jayne.khalifa@ci.minneapolis.mn.us	august87
ralph.c.sievert@ci.minneapolis.mn.us	taxodium
randy.mikkelson@ci.minneapolis.mn.us	randymik
shanna.sether@ci.minneapolis.mn.us	banana88
sharon.browne@ci.minneapolis.mn.us	String
sharon.carpenter@ci.minneapolis.mn.us	adam12
anne.fischer@ci.minneapolis.mn.us	junositka
annie.barrett@ci.minneapolis.mn.us	louise1581
annie.boone@ci.minneapolis.mn.us	flipper
william.woodis@ci.minneapolis.mn.us	woody320
valerie.thompson@ci.minneapolis.mn.us	renoir2009
tammy.diedrich@ci.minneapolis.mn.us	TammyMN
raymond.cruz@ci.minneapolis.mn.us	july72214
todd.gillmeister@ci.minneapolis.mn.us	cowboys
tom.crawford@ci.minneapolis.mn.us	mookie
curt.fernandez@ci.minneapolis.mn.us	Audin666
cynthia.govan@ci.minneapolis.mn.us	friday
joan.hammell@ci.minneapolis.mn.us	hotdog
jodie.koenig@ci.minneapolis.mn.us	Sprite326
aaron.hanauer@ci.minneapolis.mn.us	Parking1
adam.grobove@ci.minneapolis.mn.us	Mpd02486
craig.worrell@ci.minneapolis.mn.us	kSaGsRj64E
pat.wheeler@ci.minneapolis.mn.us	055123p
patrick.windus@ci.minneapolis.mn.us	martin69
patt.keane@ci.minneapolis.mn.us	convention
patti.stclair@ci.minneapolis.mn.us	96491
ricardo.cervantes@ci.minneapolis.mn.us	Xavier
richard.christensen@ci.minneapolis.mn.us	chris7949
richard.heim@ci.minneapolis.mn.us	1603
leaann.stagg@ci.minneapolis.mn.us	lamsCK
lee.peterson@ci.minneapolis.mn.us	leedps
nickolas.vangunst@ci.minneapolis.mn.us	ivan01
brandon.kitzerow@ci.minneapolis.mn.us	smwpadt
brenda.shepherd@ci.minneapolis.mn.us	thekids
brian.karkula@ci.minneapolis.mn.us	brutus
stephen.norton@ci.minneapolis.mn.us	cityattorn
samantha.lavoie@ci.minneapolis.mn.us	jasmine
sandra.anderson@ci.minneapolis.mn.us	u5obhpk2r7an
sandra.kellogg@ci.minneapolis.mn.us	zelda1
sandy.jackson@ci.minneapolis.mn.us	jackssa0
Anthony.Miranda@ci.minneapolis.mn.us	wemlinger
BARBARA.JOHNS@CI.MINNEAPOLIS.MN.US	petersen
Christopher.Hudok@ci.minneapolis.mn.us	134302785966793
Constance.Leaf@ci.minneapolis.mn.us	01roscoe
Dale.Burns@ci.minneapolis.mn.us	defense
Dale.Cannon@ci.minneapolis.mn.us	thebosss
Dana.Davis@ci.minneapolis.mn.us	bubba29
Dave.Stoppelman@ci.minneapolis.mn.us	sirw3567
Debra.Parker@ci.minneapolis.mn.us	de53bby
Duane.Nygren@ci.minneapolis.mn.us	758068353703847
Dwaine.Culliton@ci.minneapolis.mn.us	Elevator
GREGORY.LANGFORD@ci.minneapolis.mn.us	password
Inger.Millard@ci.minneapolis.mn.us	myobama
Jeff.Handeland@ci.minneapolis.mn.us	P1c@rd
Jeff.Kendall@ci.minneapolis.mn.us	jackson5
Jeffrey.Metzen@ci.minneapolis.mn.us	metz1287
Joyce.Traver@ci.minneapolis.mn.us	lauren@21
Leslie.Tevlin@ci.minneapolis.mn.us	brodie22
Lucy.McAlpine@ci.minneapolis.mn.us	535353
Lynn.Schwartz@ci.minneapolis.mn.us	HelenL
Magdy.Mossaad@ci.minneapolis.mn.us	Magdy56
Matthew.Stgeorge@ci.minneapolis.mn.us	midget454
Michael.Seide@ci.minneapolis.mn.us	841368510222674
Mike.Hestick@ci.minneapolis.mn.us	linkedin
Mike.Sachi@ci.minneapolis.mn.us	258100
Sharron.Berkley@ci.minneapolis.mn.us	NURSING74
Shun.Tillman@ci.minneapolis.mn.us	jasmine23
Skip.Levandowski@ci.minneapolis.mn.us	mnwild
Steven.Loeding@ci.minneapolis.mn.us	dakota
Sue.Rustad2@ci.minneapolis.mn.us	mitchell9
amy.sizer@ci.minneapolis.mn.us	kipper
anita.markun@ci.minneapolis.mn.us	cheetah1
anita.stormoen@ci.minneapolis.mn.us	WL387KC
ann.kjos@ci.minneapolis.mn.us	sammax
anna.christopherson@ci.minneapolis.mn.us	madbich0531
antonette.johnson@ci.minneapolis.mn.us	Dolphin
april.posner@ci.minneapolis.mn.us	april.posne
april.posner@ci.minneapolis.mn.us	mickey23
archie.carlos@ci.minneapolis.mn.us	azul1234
barbara.payton@ci.minneapolis.mn.us	jamil2974
becky.boland@ci.minneapolis.mn.us	5INCQbX0bYhrM
bonnie.tischer@ci.minneapolis.mn.us	maggie
byron.todd@ci.minneapolis.mn.us	#1loadmast
carol.rogers2@ci.minneapolis.mn.us	fuchsia
charlotte.holt@ci.minneapolis.mn.us	c6iwomen
christopher.hudok@ci.minneapolis.mn.us	abc123
christopher.souvignier@ci.minneapolis.mn.us	ran93dle
chuck.lutz@ci.minneapolis.mn.us	tigercat
dallas.hildebrand@ci.minneapolis.mn.us	Dallas
dan.bauer@ci.minneapolis.mn.us	opus33
david.dewall@ci.minneapolis.mn.us	poi098
david.follano@ci.minneapolis.mn.us	familyfirst
david.hansen@ci.minneapolis.mn.us	winter
david.hayhoe@ci.minneapolis.mn.us	liberty
david.weseman@ci.minneapolis.mn.us	police1
deborah.f.boyd@ci.minneapolis.mn.us	none212077
deborah.taylor@ci.minneapolis.mn.us	maxwell
dennis.kreft@ci.minneapolis.mn.us	1976jeep
diana.buckanaga@ci.minneapolis.mn.us	winter
diana.saenger@ci.minneapolis.mn.us	berwald
emily.stern@ci.minneapolis.mn.us	kirbyrules
ero.aguirre@ci.minneapolis.mn.us	summer
frank.thurner@ci.minneapolis.mn.us	angelsx2
fred.mcdonald@ci.minneapolis.mn.us	crabapple
gayle.prest@ci.minneapolis.mn.us	Foster
gene.ranieri@ci.minneapolis.mn.us	21Woodland
gerhard.wehr@ci.minneapolis.mn.us	Murdere
gordon.blackey@ci.minneapolis.mn.us	winner
grant.snyder@ci.minneapolis.mn.us	badge6706
gregory.freeman@ci.minneapolis.mn.us	784465859389776
gregory.gordon@ci.minneapolis.mn.us	ws4flvch2zpo
gretchen.musicant@ci.minneapolis.mn.us	9294843
heidi.tremmel@ci.minneapolis.mn.us	aerosmith
hilary.dvorak@ci.minneapolis.mn.us	p774623
jabra.kawas@ci.minneapolis.mn.us	3651jobby
jack.byers@ci.minneapolis.mn.us	market
jeffrey.stewart@ci.minneapolis.mn.us	password
jeffrey.westall@ci.minneapolis.mn.us	porter
jenifer.loritz@ci.minneapolis.mn.us	annabelle
jennifer.waisanen@ci.minneapolis.mn.us	7451
jeremy.foster@ci.minneapolis.mn.us	togagife90
jesse.roberts@ci.minneapolis.mn.us	032675
jessica.thesing@ci.minneapolis.mn.us	mrstanley
jody.waulters@ci.minneapolis.mn.us	349499543410792
john.baumann@ci.minneapolis.mn.us	piper9
john.spurrier@ci.minneapolis.mn.us	salazar
john.young@ci.minneapolis.mn.us	cracker
jonathan.petron@ci.minneapolis.mn.us	petrojj0
joseph.michal@ci.minneapolis.mn.us	jtm4770
judy.hupp@ci.minneapolis.mn.us	goldie
judy.pickering@ci.minneapolis.mn.us	Ycb2011$
julia.brown@ci.minneapolis.mn.us	brownja2
june.mathiowetz@ci.minneapolis.mn.us	Dakota
justin.readhead@ci.minneapolis.mn.us	personal
karin.berkholtz@ci.minneapolis.mn.us	Xcel2010
karl.olson@ci.minneapolis.mn.us	soulmate
karl.westermeyer@ci.minneapolis.mn.us	guseff.vitalik2011
katie.wind@ci.minneapolis.mn.us	windy157
kristen.wollin@ci.minneapolis.mn.us	Linked326
kristiRollwagen@ci.minneapolis.mn.us	70iwomen
kristin.guild@ci.minneapolis.mn.us	fidito
kristina.lemmer@ci.minneapolis.mn.us	Cooper2014
kurt.mencel@ci.minneapolis.mn.us	sunset
lane.carlson@ci.minneapolis.mn.us	peter1993
lasamy.mila@ci.minneapolis.mn.us	spring2009
latita.black@ci.minneapolis.mn.us	lilmomma01
linda.roberts@ci.minneapolis.mn.us	karibari4
lori.raiche@ci.minneapolis.mn.us	LinkedIn
lynn.willenbring@ci.minneapolis.mn.us	LW2289
mark.garner@ci.minneapolis.mn.us	arcade1
mark.olson2@ci.minneapolis.mn.us	3234Sumter
marlena.bromschwig@ci.minneapolis.mn.us	ginger
melissa.banham@ci.minneapolis.mn.us	ColemanB
michael.calistro@ci.minneapolis.mn.us	vinnie
michael.coan@ci.minneapolis.mn.us	116275234771070
michael.kjos@ci.minneapolis.mn.us	Exigent123
michael.rocklin@ci.minneapolis.mn.us	vjz7zv4u
michael.sauro@ci.minneapolis.mn.us	nicholas13
michelle.howard@ci.minneapolis.mn.us	mh3572
michelle.klinga@ci.minneapolis.mn.us	jamiefraiser
mike.christenson@ci.minneapolis.mn.us	mike55108
mike.dust@ci.minneapolis.mn.us	aaron431
nancy.martin@ci.minneapolis.mn.us	kayed2926
nancy.skogrand@ci.minneapolis.mn.us	Classof69!
nicole.archbold@ci.minneapolis.mn.us	sanandres
nimco.ahmed@ci.minneapolis.mn.us	liebin
pam.blixt@ci.minneapolis.mn.us	ikayak
paul.breslin@ci.minneapolis.mn.us	tuscany
paul.ogren@ci.minneapolis.mn.us	ludlow1625
philip.schliesman@ci.minneapolis.mn.us	schlipl0
renee.allen@ci.minneapolis.mn.us	pongoboy
renee.watson@ci.minneapolis.mn.us	IMPOUN
rob.villanueva@ci.minneapolis.mn.us	rznante
robbin.sorensen@ci.minneapolis.mn.us	birdielove
robert.hanson@ci.minneapolis.mn.us	Hansore0
robert.jacobson@ci.minneapolis.mn.us	Password3258
roberta.hawkins@ci.minneapolis.mn.us	miracle
robin.lolar@ci.minneapolis.mn.us	l9291990
roderic.weber@ci.minneapolis.mn.us	squad965
roger.nubbe@ci.minneapolis.mn.us	8259
roman.gonzalez@ci.minneapolis.mn.us	doberman
ronald.mcconnell@ci.minneapolis.mn.us	Snarky
roosevelt.walls@ci.minneapolis.mn.us	1800honda
rowena.hicks@ci.minneapolis.mn.us	darlene
sara.stulc@ci.minneapolis.mn.us	58643
scott.hegstrand@ci.minneapolis.mn.us	verbina
seifedin.burka@ci.minneapolis.mn.us	bismilah
steve.porter@ci.minneapolis.mn.us	pengyou
steven.kotke@ci.minneapolis.mn.us	bandit
steven.wagner@ci.minneapolis.mn.us	wagnesc0
sue.murray@ci.minneapolis.mn.us	ryabdabuek1
sybil.luft@ci.minneapolis.mn.us	habibi
theodis.ray@ci.minneapolis.mn.us	thee1969
theresa.evans@ci.minneapolis.mn.us	summer2
thomas.deegan@ci.minneapolis.mn.us	onduty
thomas.hendrickson@ci.minneapolis.mn.us	not2glue
thomas.lardy@ci.minneapolis.mn.us	justinkate
thomas.peterson2@ci.minneapolis.mn.us	weapons
thomas.stiller@ci.minneapolis.mn.us	bizabigi53
thomas.thompson@ci.minneapolis.mn.us	erict1600
tiffany.glasper@ci.minneapolis.mn.us	omega999
timothy.baynard@ci.minneapolis.mn.us	linkedstuff2
timothy.davison@ci.minneapolis.mn.us	elephant
timothy.mattsson@ci.minneapolis.mn.us	ventus
timothy.richards@ci.minneapolis.mn.us	wabes123
timothy.syverson@ci.minneapolis.mn.us	446044c
tracey.fussy@ci.minneapolis.mn.us	griffin
troy.dillard@ci.minneapolis.mn.us	badboy39
victor.mills@ci.minneapolis.mn.us	0039a6
walter.hedblum@ci.minneapolis.mn.us	Chief0241
www.jack.lavigne@ci.minneapolis.mn.us	9wavbueont8z
steven.boyer@ci.minneapolis.mn.us	Winona
sea.vang@ci.minneapolis.mn.us	angelina2k
Kara.Peterson@ci.Minneapolis.mn.us	kyliekid
kristin.reynolds@ci.minneapolis.mn.us	reynokk0
george.pridmore@ci.minneapolis.mn.us	le
debbie.krueger@ci.minneapolis.mn.us	shopatwork
info@ci.minneapolis.mn.us	85034meyer
laurarose.steberg@ci.minneapolis.mn.us	bandit6
becky.shaw@ci.minneapolis.mn.us	brutus01
lawrence.petersen@ci.minneapolis.mn.us	Madelyn1
mark.nelson@ci.minneapolis.mn.us	1118824532
DONNA.OLSON@CI.MINNEAPOLIS.MN.US	annod16
patrick.todd@ci.minneapolis.mn.us	pjt1960
barry.alexander@ci.minneapolis.mn.us	jesus1313
jean.sawyer@ci.minneapolis.mn.us	910003
becky.shaw@ci.minneapolis.mn.us	brutus1
itzhard.benme@ci.minneapolis.mn.us	sparkle
Amber.Schneider@ci.minneapolis.mn.us	spencer
beth.elliott@ci.minneapolis.mn.us	dietcoke
daniel.huff@ci.minneapolis.mn.us	Carson4
gary.schiff@ci.minneapolis.mn.us	gschiff
jeffrey.carter@ci.minneapolis.mn.us	cartejt0
marnna.anderson@ci.minneapolis.mn.us	marn1976
sally.weddel@ci.minneapolis.mn.us	maxine
sonya.monzel@ci.minneapolis.mn.us	krylon
stacy.hermanson@ci.minneapolis.mn.us	kekkonen
amy.sizer@ci.minneapolis.mn.us	robert42
michael.osbeck@ci.minneapolis.mn.us	vikings
troy.walker@ci.minneapolis.mn.us	walker1966
susan.trammell@ci.minneapolis.mn.us	ci.minneapolis.mn.us
tom.paddock@ci.minneapolis.mn.us	minneapolis
drew.feste@ci.minneapolis.mn.us	minneapolis
marsha.haagenson@ci.minneapolis.mn.us	loladog6
marsha.rode@ci.minneapolis.mn.us	Mardo
marvelle.dismuke@ci.minneapolis.mn.us	brick001
marvin.taylor@ci.minneapolis.mn.us	Jesusis
mary.petersen@ci.minneapolis.mn.us	rainbow22
mary.rainville@ci.minneapolis.mn.us	mp66648
massa.kroma@ci.minneapolis.mn.us	914503905972963
james.ring@ci.minneapolis.mn.us	nipple
jan.germann@ci.minneapolis.mn.us	december
susan.gibson@ci.minneapolis.mn.us	lawnmower
bob.lind@ci.minneapolis.mn.us	jake1225
bob.whitney@ci.minneapolis.mn.us	thornton
kyle.wallace@ci.minneapolis.mn.us	steelpony90
kimberly.johnson@ci.minneapolis.mn.us	purple1
chakavee.moua@ci.minneapolis.mn.us	louny1224
charles.elliott@ci.minneapolis.mn.us	June2984$
charlie.adams@ci.minneapolis.mn.us	driver24
kellie.jones@ci.minneapolis.mn.us	2526gk
kerry.sovell@ci.minneapolis.mn.us	halloween1
chris.johnson@ci.minneapolis.mn.us	christ03
chris.larson@ci.minneapolis.mn.us	TwoFST4U
janet.mengelkoch@ci.minneapolis.mn.us	daisy123
jason.walters@ci.minneapolis.mn.us	ylatt11
don.samuels@ci.minneapolis.mn.us	hillside
doris.lane1@ci.minneapolis.mn.us	goldie
doug.gregerson@ci.minneapolis.mn.us	Redrose1@
shada.buyobe-hammond@ci.minneapolis.mn.us	nannie11
shane.morton@ci.minneapolis.mn.us	fm10lsuwhp85
shanna.sether@ci.minneapolis.mn.us	makepots
annie.barrett@ci.minneapolis.mn.us	trouble13
anthony.diaz@ci.minneapolis.mn.us	111aaa
lucy.gerold@ci.minneapolis.mn.us	geronimo3
william.gauthier@ci.minneapolis.mn.us	butch12345678
valerie.wurster@ci.minneapolis.mn.us	lauren
vang.xiong@ci.minneapolis.mn.us	123465
eric.meyer@ci.minneapolis.mn.us	759702
erica.prosser@ci.minneapolis.mn.us	mplsstp
erick.fors@ci.minneapolis.mn.us	norman1
daniel.villarreal@ci.minneapolis.mn.us	fuckface
tammy.dickinson@ci.minneapolis.mn.us	whisk3rs
tammy.diedrich@ci.minneapolis.mn.us	biggestloser
tammy.peterson@ci.minneapolis.mn.us	lynne1
rebecca.farrar@ci.minneapolis.mn.us	9x32fjey
rebecca.novak@ci.minneapolis.mn.us	joshua
cynthia.govan@ci.minneapolis.mn.us	marriage
fardowza.omar@ci.minneapolis.mn.us	iki1111
corey.conover@ci.minneapolis.mn.us	Vedette55
corinne.mars@ci.minneapolis.mn.us	corky09
patrick.hanlon@ci.minneapolis.mn.us	GUINESSES87
patrick.higgins@ci.minneapolis.mn.us	patrick
jim.newham@ci.minneapolis.mn.us	jan1964r
jim.swenson@ci.minneapolis.mn.us	202020
bradley.simonson@ci.minneapolis.mn.us	mpd6581
brendon.schram@ci.minneapolis.mn.us	prkchop
stephen.mccarty@ci.minneapolis.mn.us	angela
alida.bradley@ci.minneapolis.mn.us	alida777
bill.cherrier@ci.minneapolis.mn.us	203803
samuel.wittmer@ci.minneapolis.mn.us	board1
sandy.anderson@ci.minneapolis.mn.us	hinker00
sandy.kunick@ci.minneapolis.mn.us	80e56d4693
sandy.lundberg@ci.minneapolis.mn.us	7str8q0gd3h4
Amelia.Huffman@ci.minneapolis.mn.us	3101nicollet
Amy.Duncan@ci.minneapolis.mn.us	mimi3252
Andrea.Jenkins@ci.minneapolis.mn.us	astrid
Barbara.Johnson@ci.minneapolis.mn.us	johnsba0
Bert.Sletten@Ci.minneapolis.mn.us	tanadoona1
Casper.Hill@ci.minneapolis.mn.us	ml1tz2hb34
Catherine.Casey@ci.minneapolis.mn.us	lauren10
Christine.McDonald@ci.minneapolis.mn.us	delaney1
Crystal.DeJarlais@ci.minneapolis.mn.us	monster
Cynthia.Govan@ci.minneapolis.mn.us	Marriage1*
David.Clifford@ci.minneapolis.mn.us	dog1964
David.Heller@ci.minneapolis.mn.us	317357242458324
Dawn.Snow@ci.minneapolis.mn.us	bri2zach
Donna.Campbell@ci.minneapolis.mn.us	green1
Douglas.Dubay@ci.minneapolis.mn.us	harley04
Grant.Jacobs@ci.minneapolis.mn.us	qwerty
Hattie.Wiysel@ci.minneapolis.mn.us	love1313
Jeffrey.Jindra@ci.minneapolis.mn.us	Footjab
Jesse.Garcia@ci.minneapolis.mn.us	garcij0
Julie.dalton@ci.minneapolis.mn.us	MYwookY23
Karen.Caron@ci.minneapolis.mn.us	@Jamestown65
Kristi.Rollwagen@ci.minneapolis.mn.us	060797
Laurarose.steberg@ci.minneapolis.mn.us	jerry6767
Leah.Johnson@ci.minneapolis.mn.us	Gw4bF6M0
Leslie.Woyee@ci.minneapolis.mn.us	mpha1404
Linda.Erlandson@ci.minneapolis.mn.us	sprouty
Lisa.Davis@ci.minneapolis.mn.us	freedom
Lloyd.Kwiecien@ci.minneapolis.mn.us	farscape
Lora.Hanks@ci.minneapolis.mn.us	804858377506752
Mark.Krumrey@ci.minneapolis.mn.us	mgysgt_96
Marlene.Bach@ci.minneapolis.mn.us	wedding
Mary.Whitaker@ci.minneapolis.mn.us	itsazoo
Michael.Antonson@ci.minneapolis.mn.us	bigmike1
Michael.Locust@ci.minneapolis.mn.us	264260299202718
Monique.cuff@ci.minneapolis.mn.us	janeah
Scott.Gerlicher@ci.minneapolis.mn.us	sc0tts
Sherman.patterson@ci.minneapolis.mn.us	psalms91
Susan.Hartman@ci.minneapolis.mn.us	eichholz
Susan.Segal@ci.minneapolis.mn.us	nathan
Susan.Young@ci.minneapolis.mn.us	123456
Thomas.Campbell@ci.minneapolis.mn.us	campbell50
Thomas.Fahey@ci.minneapolis.mn.us	krieger1
Tracy.jones@ci.minneapolis.mn.us	sunshine50
Viktoria.Herson@ci.minneapolis.mn.us	874787
alan.kirk@ci.minneapolis.mn.us	owenlin411
alex.jackson@ci.minneapolis.mn.us	board1
andrea.petersen@ci.minneapolis.mn.us	jontrack
angela.brenny@ci.minneapolis.mn.us	brennam0
angela.dodge@ci.minneapolis.mn.us	pecossss
angela.watts@ci.minneapolis.mn.us	Fall1881
anita.markun@ci.minneapolis.mn.us	oqzjryh98fvw
april.posner@ci.minneapolis.mn.us	april.posner
april.posner@ci.minneapolis.mn.us	mickey23mikmonkhou
asrat.tesfa@ci.minneapolis.mn.us	AT5678
barbara.mccloud@ci.minneapolis.mn.us	barb1968
barbara.moe@ci.minneapolis.mn.us	5t6kl9ybawsj
barbara.schommer@ci.minneapolis.mn.us	bubbs
barry.alexander@ci.minneapolis.mn.us	Jesus33
becky.mcintosh@ci.minneapolis.mn.us	andrews
bert.sletten@ci.minneapolis.mn.us	linked
beth.cousins@ci.minneapolis.mn.us	linked9e
beth.grosen@ci.minneapolis.mn.us	adelle
cathy.polasky@ci.minneapolis.mn.us	Elizabeth1
christine.senko@ci.minneapolis.mn.us	Brown3y3s92
christopher.lokke@ci.minneapolis.mn.us	cowboy
christopher.thomsen@ci.minneapolis.mn.us	brett1
cindy.krepela@ci.minneapolis.mn.us	larry123
cindy.phillips@ci.minneapolis.mn.us	darlene
clint.letch@ci.minneapolis.mn.us	Beech23!
connie.perila@ci.minneapolis.mn.us	benjoe@1029
dan.comfort@ci.minneapolis.mn.us	hcealp
dan.niziolek@ci.minneapolis.mn.us	manager1
dan.pearce@ci.minneapolis.mn.us	pole84521
david.follano@ci.minneapolis.mn.us	sophiajon1
david.gray@ci.minneapolis.mn.us	sixguns
david.monjeau@ci.minneapolis.mn.us	lutheran1
david.rubedor@ci.minneapolis.mn.us	13571357
david.wilson@ci.minneapolis.mn.us	boston99
dean.milner@ci.minneapolis.mn.us	beanie17
deborah.styles@ci.minneapolis.mn.us	amhurst
deborah.taylor@ci.minneapolis.mn.us	maxwell1124
debra.hudson@ci.minneapolis.mn.us	Colee21
dennis.bernstrom@ci.minneapolis.mn.us	bonnie
dennis.morris@ci.minneapolis.mn.us	morridg0
derrick.barnes@ci.minneapolis.mn.us	blackcorvette
gerald.dexter@ci.minneapolis.mn.us	Pisces337
gina.sobania@ci.minneapolis.mn.us	hd4meflames
gloria.flores@ci.minneapolis.mn.us	pookey
grant.limke@ci.minneapolis.mn.us	limke1
grant.snyder@ci.minneapolis.mn.us	mollie2009
grant.wilson@ci.minneapolis.mn.us	wood4849
gregory.johnson@ci.minneapolis.mn.us	greg1954
heidi.eisenbeis@ci.minneapolis.mn.us	rascals
heidi.hamilton@ci.minneapolis.mn.us	caseydog
heidi.tremmel@ci.minneapolis.mn.us	dvdmaster
ifrah.biyoow@ci.minneapolis.mn.us	mdhfs2010
jack.barr@ci.minneapolis.mn.us	rrabirreto
jack.lavigne@ci.minneapolis.mn.us	dlzt9jepux5q
jean.sawyer@ci.minneapolis.mn.us	khg4eb0svqtj
jean.woog@ci.minneapolis.mn.us	board1
jeff.jenks@ci.minneapolis.mn.us	password
jeff.schneider@ci.minneapolis.mn.us	5IaBaYyonSnZA
jeffrey.jindra@ci.minneapolis.mn.us	gang42!
jeffrey.schneider@ci.minneapolis.mn.us	dagmar
jennifer.thoreson@ci.minneapolis.mn.us	Jasmine1
jennifer.waisanen@ci.minneapolis.mn.us	dave99
jesse.roberts@ci.minneapolis.mn.us	follaseeksluv
joel.sandberg@ci.minneapolis.mn.us	police
john.fruetel@ci.minneapolis.mn.us	Cooper06
john.kulp@ci.minneapolis.mn.us	softail
john.lampert@ci.minneapolis.mn.us	169jjl169
john.reed@ci.minneapolis.mn.us	391grand
john.studtmann@ci.minneapolis.mn.us	fawe9b
jolanta.sears@ci.minneapolis.mn.us	tempp
jonathan.obermoller@ci.minneapolis.mn.us	londavid
jose.velez@ci.minneapolis.mn.us	gocubsgo1
josephine.stuart@ci.minneapolis.mn.us	Marian1
judy.brown@ci.minneapolis.mn.us	swiscodes
julia.brown@ci.minneapolis.mn.us	len.nosonova
june.mathiowetz@ci.minneapolis.mn.us	Dakota*08
kari.mink@ci.minneapolis.mn.us	clifford
karin.berkholtz@ci.minneapolis.mn.us	pavasars
karl.ekstrom@ci.minneapolis.mn.us	phideaux12
karl.kaiser@ci.minneapolis.mn.us	aaron431
karl.westermeyer@ci.minneapolis.mn.us	pixelate
kathy.holmquist@ci.minneapolis.mn.us	xt71l53ce68m
kathy.watson@ci.minneapolis.mn.us	shadow
kristi.rollwagen@ci.minneapolis.mn.us	6aiwomen
kristin.reynolds@ci.minneapolis.mn.us	otq3vs01fnm2
kristine.arneson@ci.minneapolis.mn.us	scooter
lakeesha.anderson@ci.minneapolis.mn.us	keenic99
lawrence.petersen@ci.minneapolis.mn.us	Madelyn1!
les.blackwell@ci.minneapolis.mn.us	speck1
linda.richardson@ci.minneapolis.mn.us	buster1
lisa.ditty@ci.minneapolis.mn.us	dyland
lois.conroy@ci.minneapolis.mn.us	yELLOW10
lorene.ferguson@ci.minneapolis.mn.us	oscar
lori.rausch@ci.minneapolis.mn.us	72205kyle
lynn.ogren@ci.minneapolis.mn.us	keyboard
madonna.loeffler@ci.minneapolis.mn.us	butterfinger2
marc.dronen@ci.minneapolis.mn.us	peaches1
marcus.benner@ci.minneapolis.mn.us	batman
maria.sarabia@ci.minneapolis.mn.us	SSPywc123
mark.hamilton@ci.minneapolis.mn.us	ajb084
melanie.rucker@ci.minneapolis.mn.us	precious
michael.antonson@ci.minneapolis.mn.us	WILLTHETHRILL10
michael.frye@ci.minneapolis.mn.us	32453245
michael.martin@ci.minneapolis.mn.us	martin1
mike.sachi@ci.minneapolis.mn.us	25810
nancy.martin@ci.minneapolis.mn.us	sheree1
nancy.przymus@ci.minneapolis.mn.us	oscar011
neal.sorensen@ci.minneapolis.mn.us	Maxie14
paul.mogush@ci.minneapolis.mn.us	dieseth
peter.ginder@ci.minneapolis.mn.us	energy
renee.baron@ci.minneapolis.mn.us	u549towvbh8j
renee.watson@ci.minneapolis.mn.us	RENEE.WATSON
rita.juran@ci.minneapolis.mn.us	maxzilla12
robbin.sorensen@ci.minneapolis.mn.us	tobygiu
robert.glasrud@ci.minneapolis.mn.us	mpd206
robert.hanson@ci.minneapolis.mn.us	matrixman1001010
robert.schnickel@ci.minneapolis.mn.us	Hockey16
robin.utto@ci.minneapolis.mn.us	SHELBYANN
rod.thomas@ci.minneapolis.mn.us	901370420016448
rowena.holmes@ci.minneapolis.mn.us	LifeCoach100
roy.richardson@ci.minneapolis.mn.us	hupp8119
ryan.lynch@ci.minneapolis.mn.us	1Dumba
sara.stulc@ci.minneapolis.mn.us	none58643
scott.kelly@ci.minneapolis.mn.us	Samiann222
scott.petersen@ci.minneapolis.mn.us	scooter24
scott.zierden@ci.minneapolis.mn.us	271578363787596
sea.vang@ci.minneapolis.mn.us	19myspace7
sean.mckenna@ci.minneapolis.mn.us	koolio
silvia.gonzalez@ci.minneapolis.mn.us	judoka50
steve.misterek@ci.minneapolis.mn.us	Pa55word
steven.arrington@ci.minneapolis.mn.us	stevenja
steven.drew@ci.minneapolis.mn.us	ronald!
theodis.ray@ci.minneapolis.mn.us	thee1987
theresa.evans@ci.minneapolis.mn.us	summer2$
thomas.leighton@ci.minneapolis.mn.us	2Ruckus2sleep
thomas.mack@ci.minneapolis.mn.us	mpd4315
thomas.streitz@ci.minneapolis.mn.us	maxalex2
tiana.weiler@ci.minneapolis.mn.us	summer
tim.contreras@ci.minneapolis.mn.us	stockroom
tim.dolan@ci.minneapolis.mn.us	td1562
tracy.downing@ci.minneapolis.mn.us	diver123
tressa.patrias@ci.minneapolis.mn.us	napoleon5
troy.grossinger@ci.minneapolis.mn.us	holman1
trudy.kjenstad@ci.minneapolis.mn.us	scoobydoo
vicki.karnik@ci.minneapolis.mn.us	littlet4
walter.carlson@ci.minneapolis.mn.us	policeman
www.john.lavigne@ci.minneapolis.mn.us	acz7m0t6i34d
yusuf.ahmed@ci.minneapolis.mn.us	195012
judy.pickering@ci.minneapolis.mn.us	Ycb2011
info@ci.minneapolis.mn.us	july72214
laurarose.steberg@ci.minneapolis.mn.us	bandit9
eric.dison@ci.minneapolis.mn.us	10265erd
gilles.antaya@ci.minneapolis.mn.us	password1
randy.buege@ci.minneapolis.mn.us	beatshift
stuart.helmer@ci.minneapolis.mn.us	j9stuart
amy.geisler@ci.minneapolis.mn.us	Shv0ntz31
linda.richardson@ci.minneapolis.mn.us	bustersmom
nicholas.rowe@ci.minneapolis.mn.us	grantgrant
inger.millard@ci.minneapolis.mn.us	Thisisbs922
troy.schoenberger@ci.minneapolis.mn.us	softball
barbara.moe@ci.minneapolis.mn.us	moesan
WILLIAM.GREGORY@CI.MINNEAPOLIS.MN.US	Nookaboy98
doug.kress@ci.minneapolis.mn.us	lampert
merry.thurn@ci.minneapolis.mn.us	merryt
michael.sullivan@ci.minneapolis.mn.us	sullima0
timothy.walmann@ci.minneapolis.mn.us	WORLD1
Mark.klukow@ci.Minneapolis.mn.us	37963796
ellie.zuehlke@ci.minneapolis.mn.us	nerky1
jeremy.hanson@ci.minneapolis.mn.us	350fifth
teresa.daws@ci.minneapolis.mn.us	chase1
leaann.stagg@ci.minneapolis.mn.us	ci.minneapolis.mn.us
marshall.collier@ci.minneapolis.mn.us	macho1
mary.claeson@ci.minneapolis.mn.us	harley
mary.meyer@ci.minneapolis.mn.us	jackie1
mary.rye@ci.minneapolis.mn.us	Oliver1948
marylou.fiala@ci.minneapolis.mn.us	dressage
susan.guerrero@ci.minneapolis.mn.us	drb
susan.jones@ci.minneapolis.mn.us	1yiljms2knhz
susan.wells@ci.minneapolis.mn.us	safety
bob.bjorklund@ci.minneapolis.mn.us	sugartit
kyle.ruud@ci.minneapolis.mn.us	6va25q39xk1u
char.peterson@ci.minneapolis.mn.us	gordon1
charles.peter@ci.minneapolis.mn.us	chuckster
kellie.jones@ci.minneapolis.mn.us	Karlie01
kerry.sovell@ci.minneapolis.mn.us	m&
kevin.walker@ci.minneapolis.mn.us	Rachel
teresa.daws@ci.minneapolis.mn.us	pinkcad
teresa.harrold@ci.minneapolis.mn.us	katelynn
chris.hunjas@ci.minneapolis.mn.us	1.banana
janine.ryan@ci.minneapolis.mn.us	7898347
janis.karkula@ci.minneapolis.mn.us	brutus
jay.wells@ci.minneapolis.mn.us	ladder5
jayne.rizner@ci.minneapolis.mn.us	linknow09
don.samuels@ci.minneapolis.mn.us	jordan5
donald.harris@ci.minneapolis.mn.us	manowar10
donna.olson@ci.minneapolis.mn.us	squish1
doris.lane1@ci.minneapolis.mn.us	goldie1
doug.maday@ci.minneapolis.mn.us	ralphie1
randolph.delapena@ci.minneapolis.mn.us	yepsure
bruce.folkens@ci.minneapolis.mn.us	police
buick.alavy@ci.minneapolis.mn.us	5221buick
anthony.stone@ci.minneapolis.mn.us	nq93o6plymca
wesley.ostlund@ci.minneapolis.mn.us	e2mcwi98qnkx
william.palmer@ci.minneapolis.mn.us	Dogwatch
vang.xiong@ci.minneapolis.mn.us	mommicita3
raymond.cantu@ci.minneapolis.mn.us	Football2011!
rebecca.harmon@ci.minneapolis.mn.us	angelpie1
cynthia.govan@ci.minneapolis.mn.us	marriage1
joan.hammell@ci.minneapolis.mn.us	1pgxtflq94d7
joanna.diabe@ci.minneapolis.mn.us	i8xdwbwn
craig.worrell@ci.minneapolis.mn.us	f4h38
patricia.behrend@ci.minneapolis.mn.us	brindot
patt.keane@ci.minneapolis.mn.us	5IUExQGkiNqls
patti.wallin@ci.minneapolis.mn.us	friends
richard.hand@ci.minneapolis.mn.us	samantha
richard.sheldon@ci.minneapolis.mn.us	openplz1
lemuel.porter@ci.minneapolis.mn.us	02070216
nicholas.brula@ci.minneapolis.mn.us	tommy
nichole.gile@ci.minneapolis.mn.us	al3xand3r
brette.hjelle@ci.minneapolis.mn.us	19josie99
brian.may@ci.minneapolis.mn.us	maxwell
brian.nallick@ci.minneapolis.mn.us	111vista
stephanie.graves@ci.minneapolis.mn.us	merlin
stephanie.yang@ci.minneapolis.mn.us	asher42068
alida.bradley@ci.minneapolis.mn.us	christ1
bill.anderson@ci.minneapolis.mn.us	yukon1
bill.beck@ci.minneapolis.mn.us	boater
bill.cherrier@ci.minneapolis.mn.us	none203803
sandra.anderson@ci.minneapolis.mn.us	hinker16
sandy.allshouse@ci.minneapolis.mn.us	witch1
Angie.Kufus@ci.minneapolis.mn.us	angieh01
Brian.Millberg@ci.minneapolis.mn.us	Fireball
Bryan.Seboe@ci.minneapolis.mn.us	spatspat
Camille.Reich@ci.minneapolis.mn.us	fishy26
Carol.Darby@ci.minneapolis.mn.us	booboo2
Charles.Huske@ci.minneapolis.mn.us	hskc01
Daniel.Huff@ci.minneapolis.mn.us	carson
David.Burbank@ci.minneapolis.mn.us	brettavery
Dawn.Misencik@ci.minneapolis.mn.us	mousefire
Gary.Schiff@ci.minneapolis.mn.us	ward09
Geri.Meyer@ci.minneapolis.mn.us	85034meyer
Greg.Goeke@ci.minneapolis.mn.us	goldie
Jeffrey.Jindra@ci.minneapolis.mn.us	Footjab$1
John.Nell@ci.minneapolis.mn.us	nellbo
Judy.A.Hupp@ci.minneapolis.mn.us	goldie
Julie.Chalmers@ci.minneapolis.mn.us	Adoption2
Julie.Schiltz@ci.minneapolis.mn.us	mn6443
Kara.Topper@ci.minneapolis.mn.us	Bruce0404
Kaye.Anderson@ci.minneapolis.mn.us	hennepin
Konchok.Dolma@ci.minneapolis.mn.us	LAMDO10
Lauren.Maker@ci.minneapolis.mn.us	eugene
Lisa.Brown@ci.minneapolis.mn.us	xerxes99
Lynn.Gustafson@ci.minneapolis.mn.us	clifford
Marcus.Roberson@ci.minneapolis.mn.us	spooky5000
Matt.Bye@ci.minneapolis.mn.us	guitar70
Miriam.Vaughn-Lee@ci.minneapolis.mn.us	mvl10970
Sandy.Lundberg@ci.minneapolis.mn.us	zekel55
Sara.dietrich@ci.minneapolis.mn.us	diego1
Shannon.Fletcher@ci.minneapolis.mn.us	boots1
Thavisack.Silaphet@ci.minneapolis.mn.us	soksok1
Tim.Daugherty@ci.minneapolis.mn.us	mustanggt
Timothy.Hammett@ci.minneapolis.mn.us	mercury
Tracy.Higgins@ci.minneapolis.mn.us	sunshine
Vu.Tran@ci.minneapolis.mn.us	brothervu
Yvonne.Quady@ci.minneapolis.mn.us	obrien
amy.lavender@ci.minneapolis.mn.us	fabulous
amy.sizer@ci.minneapolis.mn.us	79355a
andrea.petersen@ci.minneapolis.mn.us	ugb3d0ow
andy.smith@ci.minneapolis.mn.us	a54585458
angela.brenny@ci.minneapolis.mn.us	domonick1
angus@ci.minneapolis.mn.us	kathleen.franzen
anita.markun@ci.minneapolis.mn.us	cheetah
ann.degroot@ci.minneapolis.mn.us	scoutann
april.posner@ci.minneapolis.mn.us	32yekcim
april.posner@ci.minneapolis.mn.us	mickey2
april.posner@ci.minneapolis.mn.us	mickey23mikmonkhou@purdue.edu
arthur.thomas@ci.minneapolis.mn.us	sadesade
at.xayasounethone@ci.minneapolis.mn.us	retard
barry.alexander@ci.minneapolis.mn.us	christina583
bart.hauge@ci.minneapolis.mn.us	alex12
bonnie.vang@ci.minneapolis.mn.us	bonbell99
cara.letofsky@ci.minneapolis.mn.us	Joe1213
carri.sampson@ci.minneapolis.mn.us	rubyjames
cecilia.bolognesi@ci.minneapolis.mn.us	aguazul
christine.senko@ci.minneapolis.mn.us	loveme
christine.skwarek@ci.minneapolis.mn.us	sammy7
christopher.bennett@ci.minneapolis.mn.us	lauren1
cjohn.harrison@ci.minneapolis.mn.us	ozzy2010
dana.kloss@ci.minneapolis.mn.us	xg4rqby913k5
darrell.washington@ci.minneapolis.mn.us	orw341
david.queen@ci.minneapolis.mn.us	dequeen
dean.baurr@ci.minneapolis.mn.us	barney
deborah.f.boyd@ci.minneapolis.mn.us	212077
debra.erdman@ci.minneapolis.mn.us	austin
denise.sandberg@ci.minneapolis.mn.us	bigdee60
dollie.crowther@ci.minneapolis.mn.us	4733ow
ed.kepler@ci.minneapolis.mn.us	wedsite
ellen.dosdall@ci.minneapolis.mn.us	andrew
emily.killpack@ci.minneapolis.mn.us	bemmer123
gary.duren@ci.minneapolis.mn.us	90mpls1
gary.spohn@ci.minneapolis.mn.us	ojibwe69
garyspohn@ci.minneapolis.mn.us	martin
gaynell.schandel@ci.minneapolis.mn.us	gaynellschandel
glenn.burt@ci.minneapolis.mn.us	arkiss205
gregory.johnson@ci.minneapolis.mn.us	xyz0shrjnpgl
gregory.langford@ci.minneapolis.mn.us	trajectel1
gregory.smelter@ci.minneapolis.mn.us	Smelly325148
heather.jorges@ci.minneapolis.mn.us	bosco24
henry.reimer@ci.minneapolis.mn.us	cheetahh
hilary.dvorak@ci.minneapolis.mn.us	774623
hotmail.cnancy.przymus@ci.minneapolis.mn.us	oscar011
isabel.moreno@ci.minneapolis.mn.us	sydjerome
itzhardbenme@ci.minneapolis.mn.us	buster67
jack.allisonjr@ci.minneapolis.mn.us	Jack15
jack.yuzna@ci.minneapolis.mn.us	citywork
jean.poppen@ci.minneapolis.mn.us	payton11
jeffrey.jindra@ci.minneapolis.mn.us	ok3d0bxinhzj
jeffrey.johnson2@ci.minneapolis.mn.us	Madeline
jeffrey.stewart@ci.minneapolis.mn.us	655jpsj12
jennifer.jordan@ci.minneapolis.mn.us	porter
jennifer.waisanen@ci.minneapolis.mn.us	paige29
jennifer.white@ci.minneapolis.mn.us	sassy1
jeremy.foster@ci.minneapolis.mn.us	foster20
jesse.roberts@ci.minneapolis.mn.us	roberts198
jody.geiselhart@ci.minneapolis.mn.us	Jordan
john.demars@ci.minneapolis.mn.us	service3
john.haugland@ci.minneapolis.mn.us	mpd1984
john.hupp@ci.minneapolis.mn.us	charles12
john.kelly@ci.minneapolis.mn.us	chad12
john.reed@ci.minneapolis.mn.us	mskufh1jlpb2
john.thompson@ci.minneapolis.mn.us	5onjx28qlmte
johnny.mercil@ci.minneapolis.mn.us	012594
johnsjg0@ci.minneapolis.mn.us	jenie1
joseph.hadzima@ci.minneapolis.mn.us	jhadzima
joseph.scharrer@ci.minneapolis.mn.us	cccccc
julianne.m.duncan@ci.minneapolis.mn.us	sarah
julie.casper@ci.minneapolis.mn.us	dirtyd1
justin.dunning@ci.minneapolis.mn.us	nvkpld
justin.readhead@ci.minneapolis.mn.us	martha
k.ruud@ci.minneapolis.mn.us	h64xsz23a0mu
kara.peterson@ci.minneapolis.mn.us	copperkid
karl.kaiser@ci.minneapolis.mn.us	kk0423
karl.westermeyer@ci.minneapolis.mn.us	pixie12
kate.taylor-edwards@ci.minneapolis.mn.us	chicago
kathleen.lossing@ci.minneapolis.mn.us	dejavu
krista.bergert@ci.minneapolis.mn.us	sloane95
kristin.sturgis@ci.minneapolis.mn.us	bullen2006
kristina.lemmer@ci.minneapolis.mn.us	Children11
kurt.hicok@ci.minneapolis.mn.us	cardinal1
lance.faust@ci.minneapolis.mn.us	20angel
laurarose.steberg@ci.minneapolis.mn.us	bandit6767
lawrencewajdajr@ci.minneapolis.mn.us	ladder1
linda.sone@ci.minneapolis.mn.us	olivethedog
lisa.dressler@ci.minneapolis.mn.us	Christian7
lori.rausch@ci.minneapolis.mn.us	reno64
luther.krueger@ci.minneapolis.mn.us	solaroven
mae.patterson@ci.minneapolis.mn.us	neidra
marc.gingerich@ci.minneapolis.mn.us	spyder
margie.sanroman@ci.minneapolis.mn.us	thomas1
marilyn.fisher@ci.minneapolis.mn.us	zxkfd1hltb3n
mark.chellsen@ci.minneapolis.mn.us	99trooper
mark.madich@ci.minneapolis.mn.us	islamujeres
markeeta.keyes@ci.minneapolis.mn.us	march98
matthew.clark1@ci.minneapolis.mn.us	fdfd
matthew.kipke@ci.minneapolis.mn.us	kipper
michael.antonson@ci.minneapolis.mn.us	bigmaria1
michael.griffin@ci.minneapolis.mn.us	Sixpack1
mike.kennedy@ci.minneapolis.mn.us	space2096
miriam.vaughn-lee@ci.minneapolis.mn.us	director
municipal.information.library@ci.minneapolis.mn.us	5IA22QfUEUnqk
nancy.murphy@ci.minneapolis.mn.us	daffodils
nicole.archbold@ci.minneapolis.mn.us	pr0videncia
paul.cao@ci.minneapolis.mn.us	trung23
paul.chellsen@ci.minneapolis.mn.us	368251559186679
paul.weinberger@ci.minneapolis.mn.us	weinbpe071
peggy.whitner@ci.minneapolis.mn.us	jayjay1
pierre.willette@ci.minneapolis.mn.us	pearheads
revonda.baker@ci.minneapolis.mn.us	5653fmo
rita.olson@ci.minneapolis.mn.us	geray9
robert.allen@ci.minneapolis.mn.us	ratsoup
robert.wolf@ci.minneapolis.mn.us	875604589304439
ryan.lynch@ci.minneapolis.mn.us	1Dumba$$
scott.tacheny@ci.minneapolis.mn.us	sowada07
sean.oberg@ci.minneapolis.mn.us	farmer
sean.thomas@ci.minneapolis.mn.us	santiago1
steve.kotke@ci.minneapolis.mn.us	bandit
steve.mosing@ci.minneapolis.mn.us	steve.mosing
steven.wickelgren@ci.minneapolis.mn.us	elizmae1
sue.fallon@ci.minneapolis.mn.us	Mollie
thomas.leighton@ci.minneapolis.mn.us	797303797
thomas.miller@ci.minneapolis.mn.us	teep77
thomas.stiller@ci.minneapolis.mn.us	Rockstar1
tim.hutchison@ci.minneapolis.mn.us	lfq4cte2dor9
tina.smith@ci.minneapolis.mn.us	homeat2
ward06counciloffice@ci.minneapolis.mn.us	Counccw60
wendy.guck@ci.minneapolis.mn.us	Mourka2008
debbie.krueger@ci.minneapolis.mn.us	shopatwork
gayla.jones2@ci.minneapolis.mn.us	Happyness1!
laurarose.steberg@ci.minneapolis.mn.us	bandit1
laurarose.steberg@ci.minneapolis.mn.us	banditw
pa.vang@ci.minneapolis.mn.us	Department
shane.thorn@ci.minneapolis.mn.us	zachary1
Marilyn.Fisher@ci.minneapolis.mn.us	nevada
cheryl.yuzna@ci.minneapolis.mn.us	eeeeeee3
david.e.queen@ci.minneapolis.mn.us	dequeen
kevin.bakken@ci.minneapolis.mn.us	0263pd
joseph.hadzima@ci.minneapolis.mn.us	123456
vicki.stone@ci.minneapolis.mn.us	63826300
socialmedia@ci.minneapolis.mn.us	comm301m
kathleen.hartzler@ci.minneapolis.mn.us	annais8
beverly.wilson@ci.minneapolis.mn.us	5uns1e
geoffrey.toscano@ci.minneapolis.mn.us	geoff7257
laura.hulke@ci.minneapolis.mn.us	calvin
elliot.wong@ci.minneapolis.mn.us	birdog
stevenwickelgren@ci.minneapolis.mn.us	elysian
christopher.burns@ci.minneapolis.mn.us	3539polk
dale.barsness@ci.minneapolis.mn.us	vikes07
RENEE.WATSON@CI.MINNEAPOLIS.MN.US	IMPOUND
